*****************************************************************
*A              * *                         *   *     *   *     *
***** * * ***** *** ********** **** ***** * * * *** * * * ***** *
*   * * *       *   *             *     * *   *     *   *       *
*** * * ************* *********** ***** * ***************** * ***
*     *   *       *   *       * * *     *     *         *   *   *
* ***** * ******* * *** ***** * * ***** ***** ********* * ***** *
* *   * *   *   *   *   *   *   *     * *   *       *   * *     *
*** * * * * * * ***** * * * *** ***** * * ********* * * * * *** *
*   *   * * * *   *   * * * *   *     *   *     *   * * *   * * *
* ***** * * * *** * *** * * ***** ******* * *** * *** * ***** * *
*   *       * *   * * * * *       *     * * * *   *   *   *   * *
* * * *** ***** *** * * * ********* ***** * * ***** ***** * *** *
* * * *       * *   * * *         *       * *   *       *   *   *
* * *** ***** * * *** * * *** *** ********* * * * ***** ***** ***
* *       *               *                                    B*
*****************************************************************
